1111111111111111111111111111111111
1A0000000010000C00000C0000000000B1
1010010100100000101001000000010101
10100100101010100M1001000000010101
1P0000E00C00C0000000G00000000000C1
1111111111111111111111111111111111