1111111111111111111111111111111111
1E000A000000000C00000C000000000001
1010010100100000101001000000011101
101001B01010101M001001000000011101
1P0000000C00C0000000000G00000000C1
1111111111111111111111111111111111